242,243,243,243,244,0,0,0,0,0
282,283,283,283,284,0,0,0,0,0
322,323,363,283,284,0,0,0,0,0
0,0,322,323,324,0,0,0,0,0
0,0,0,0,0,0,0,0,0,0
0,0,0,0,0,0,1174,1175,1176,0
0,0,0,0,0,0,1214,1215,1216,0
0,0,0,0,0,0,1254,1255,1256,0
0,0,0,0,0,0,0,0,0,0
0,0,0,0,0,0,0,0,0,0
